11111111
10C0E101
10E00C01
1000P001
11111111