11111111
1P00C011
1C01E001
11111111
