11111111
10C0E101
10E00C01
10P0P001
11111111