11111111
10C0E1P1
10E00C01
10I00001
11111111