111111111111111111111111111111111111111111111111111111111111111111111111111111111
1000C011110000000000000CCE0000001111111000000000000000000000011111100000000000111
1C01E00000000CC1111100000000000000000000C1111111111111111110000000000000000000001
100000000000000000000000000000000111100000000000000000000000000000000000000000001
111111111111111111000001111111111111111111111111111111000000111111111111111111111
100000000000000000000000000000000000000000000000000000000000000000000000000000011
100000000000000000000000000000000000000000000000000000000000000000000000000000011
100000000000000000000000000000000000000000000000000000000000000000000000000000011
111111111111111111000001111111111111111111111111111111000000111111111111111111111
1C01E00000000CC1111100000P00000000000000C1111111111111111110000000000000000000001
1000000000000000000000000000E0000111110000000000000000000000000000000011111111111
111111111100000000000001111111000000000000000000000011111111111111111111111111111
111111111111111111111111111111111111111111111111111111111111111111111111111111111