11111
10001
1C001
1P111
110E1
11111