11111
10P11
1CE11
10001
11111
