111111111111111111111111111111111111
1P0000000000000000000000000000000001
100000000000111111111E00000000000001
100000100000000000CCC1111110000001E1
100000100000000000000000C00000111111
100011111111110000000000001111111111
111111111111111111111111111111111111