111111111111111111111111111111111111
1PE000000000000000000000000000000001
100000000000111111111E00000000000001
100000100000E00000CCC1111110000001E1
1000001000000001000C0000C00000111111
1000111111111100000C0000001111111111
111111111111111111111111111111111111