1111111111
1111000111
10P0P0E011
1100E00001
1000C00111
1111111111